011001110010001001111000011000
010010110101110001011010100100
000001110001100111011010011100
000000011010000001000110010110
101101100000110101111100011011
000111100110000101100111101000
101011011101111010010101110111
110110011011110100010101111011
011100010000010110000100101111
001110000100110100101111011100
100011110100100111011101011100
110011110111110010011010101010
011010000111001000110010111000
001101000000000010010010011111
011100101010011001010100110011
010010001100010111011101110110
100000101101001101000000001001
110001111011011001101100111111
110101101001011111110111111011
011001111100010011110010010010
011111110111101001110011011000
000100000001000001111100001110
010100101101111111001000001100
101101100100000000010010111100
000010110111110111111011001110
101001011011011111110001001110
101111111110101010001100101110
000111111000110110111011111100
001000011111001101101001001010
111000111100101001000100110111
